6 23 23 6 6 6 6 6 6 6 6 6 6 6 6 6 6 6 6 6 6 6 6 6 6 6 6 6 6 6 6 6 6 6 6 6 6 
6 4 4 4 4 4 4 4 4 4 4 4 4 4 4 4 4 4 4 4 4 4 4 4 4 4 4 4 4 4 4 4 4 4 4 4 4 6
6 4 4 4 4 4 4 4 4 4 4 4 4 4 4 4 4 4 4 4 4 4 4 4 4 4 4 4 4 4 4 4 4 4 4 4 4 6
6 4 4 4 4 4 4 4 4 4 4 4 4 4 4 4 4 4 4 4 4 4 4 4 4 4 4 4 4 4 4 4 4 4 4 4 4 6
6 4 4 4 4 4 4 4 4 4 4 4 4 4 4 4 4 4 4 4 4 4 4 4 4 4 4 4 4 4 4 4 4 4 4 4 4 6
6 4 4 4 4 4 4 4 4 4 4 4 4 4 4 4 4 4 4 4 13 13 13 13 13 13 13 13 4 25 25 4 4 4 4 4 4 6
6 4 4 4 4 4 4 4 4 4 4 4 4 4 4 4 4 4 4 4 12 14 14 14 14 14 14 12 4 26 26 4 4 4 4 4 4 6
6 4 4 4 4 4 4 4 4 4 4 4 4 4 4 4 4 4 4 4 12 14 14 14 14 14 14 12 4 26 26 4 4 4 4 4 4 6
6 4 4 4 4 4 4 4 4 4 4 4 4 4 4 4 4 4 4 4 12 14 14 14 14 14 14 12 4 26 26 4 4 4 4 4 4 6
6 4 4 4 4 4 4 4 4 4 4 4 4 4 4 4 4 4 4 4 12 14 14 14 14 14 14 12 4 26 26 4 4 4 4 4 4 6
6 4 4 4 4 4 4 4 4 4 4 4 4 4 4 4 4 4 4 4 12 14 14 14 14 14 14 12 4 26 26 4 4 4 4 4 4 6
6 4 4 4 4 4 4 4 4 4 4 4 4 4 4 4 4 4 4 4 12 14 14 14 14 14 14 12 4 26 26 4 4 4 4 4 4 6
6 4 4 4 4 4 4 4 4 4 4 4 4 4 4 4 4 4 4 4 12 14 14 14 14 14 14 12 4 26 26 4 4 4 4 4 4 6
6 4 4 4 4 4 4 4 4 4 4 4 4 4 4 4 4 4 4 4 12 14 14 14 14 14 14 12 4 26 26 4 4 4 4 4 4 6
6 4 4 4 4 4 4 4 4 4 4 4 4 4 4 4 4 4 4 4 13 13 13 13 13 13 13 13 4 25 25 4 4 4 4 4 4 6
6 4 4 4 4 4 4 4 4 4 4 4 4 4 4 4 4 4 4 4 4 4 4 4 4 4 4 4 4 4 4 4 4 4 4 4 4 6
6 4 4 4 4 4 4 4 4 4 4 4 4 4 4 4 4 4 4 4 4 4 4 4 4 4 4 4 4 4 4 4 4 4 4 4 4 23
6 4 4 4 4 4 4 4 4 4 4 4 4 4 4 4 4 4 4 4 4 4 4 4 4 4 4 4 4 4 4 4 4 4 4 4 4 23
6 6 6 6 6 6 6 6 6 6 6 6 6 6 6 6 6 6 6 6 6 6 6 6 6 6 6 6 6 6 6 6 6 6 6 6 6 6
